Date:,Checking:,Savings:,Total:,Change:,Note:
01/11/16,0,0,0,0,0
11/01/2017,3,6,9,9,turtle
11/01/2017,6,12,18,9,turtle
11/01/2017,9,18,27,9,turtle
11/01/2017,12,18,30,3,orb
11/01/2017,15,24,39,9,turtle
11/01/2017,18,24,42,3,orb
11/01/2017,18,29,47,5,zorb
11/01/2017,20,29,49,2,condoms
11/01/2017,23,35,58,9,turtle
11/01/2017,26,35,61,3,orb
11/01/2017,26,40,66,5,zorb
11/01/2017,28,40,68,2,condoms
